...#####################################
.........................#..........#..#
#.....#######..#######..####..####..#..#
#...........#.....#.....#..#..#..#.....#
####..#..#..#..#..####..#..#..#..#..#..#
#.....#..#..#..#........#........#..#..#
#..#..#..#..................###..#..#..#
#..#..#..#..........................####
#..#.....##...................####..#..#
#..#.....#....................#..#..#..#
#######.......................#..#..#..#
#..#.....#.......................#.....#
#..####..##.................###..#..#..#
#...................................#..#
#..####..####.....#..####..####..####..#
#........#..#.....#..#...........#..#..#
####..#..#..##########..######..##..#..#
#.....#...........#..#.....#........#..#
#..#######.....#..#..#..#..#######.....#
#........#.....#........#..............#
###...#######..#..####..#..####..#######
#...........#..#.....#..#..#...........#
#..##########..####..#..#..#..#..#..#..#
#........#.....#..#..#..#..#..#..#..#..#
#..####..#..#..#..#..####..####..#..#..#
#.....#..#..#........#...........#..#..#
#..####..#######..##########..#..#..####
#.............................#..#.....#
#..#.....#...............######..#######
#..#.....#.................#...........#
#..####..#.................##########..#
#.....#..#.................#........#..#
#..####..#....................####..####
#.....#..#....................#.....#..#
####.....#..#######..#..#######..#.....#
#........#...........#...........#.....#
#..####..######...####..#..#..#..####..#
#..#..#..#..............#..#..#........#
#..#..######..#####..####..#####..###...
#..............#........#...........#...